00011111110000000000000000000000
00011111110000000000000000000000
00011111110000000000000000000000
00001111110000111100000000000000
00000000000000111110000000000000
00000000000000111110000000000000
00000000000000111110000000000000
00000011110000111110000000000000
00000011110000000000000000000000
00000011110000000000000110000000
00000011110000000000001111100000
00000011110000000000001111100000
00000000000000111111111111100000
00000000000000111111111111111111
00000000000000111111111111111111
00000000000000111111111111111111
00000000000000111111111111111111
00001111000000000000111111111111
00001111000000000000000000000000
00001111000000000000000000000000
00001111000000000000000000000000
00001111000001111111100000000000
00001111000001111111100000000000
00000000000001111111100000000000
00000000000001111111100000000000
00000000000001111111000000000000
00000000000000000000000011111111
00000000000000000000000011111111
00000000000000000000000011111111
00000000000000000000000011111111
00000000000000000000000011111111
00000000000000000000000011111111
