
0 39 1 1 1 1 1 1 1 1 1 21 20 19 18 17 16 15 14 13 12 11 10 9 8 7 6 5 4 3 4 5 
0 38 1 1 1 1 1 1 1 1 1 20 19 18 17 16 15 14 13 12 11 10 9 8 7 6 5 4 3 2 3 4 
0 37 1 1 1 1 1 1 1 1 1 21 20 1 1 1 1 1 1 11 10 9 8 7 6 5 4 3 2 1 2 3 
0 36 1 1 1 1 1 1 1 1 1 22 21 1 1 1 1 1 1 1 2 8 7 6 5 4 3 2 1 2 1 2 
0 35 34 1 1 1 1 1 1 1 1 23 22 1 1 1 1 1 1 1 10 9 8 7 6 5 4 3 2 1 2 3 
0 34 33 32 31 30 29 28 27 26 25 24 23 1 1 1 1 1 1 1 11 10 9 8 7 6 5 4 3 2 3 4 
0 35 34 33 32 1 1 1 1 1 1 25 24 1 1 1 1 1 1 1 12 11 10 9 8 7 6 5 4 3 4 5 
0 36 35 34 33 1 1 1 1 1 1 26 25 1 1 1 1 1 1 1 13 12 11 10 9 8 7 6 5 4 5 6 
0 37 36 35 34 1 1 1 1 1 1 25 24 1 1 1 1 1 1 1 14 13 1 1 1 1 8 7 6 5 6 7 
0 38 37 36 35 1 1 1 1 1 1 2 23 22 21 20 19 18 17 16 2 1 1 1 1 1 1 1 7 6 7 8 
0 39 38 37 36 1 1 1 1 1 1 25 24 23 22 21 20 19 18 17 16 1 1 1 1 1 1 1 8 7 8 9 
0 40 39 38 37 1 1 1 1 1 1 26 25 1 1 1 1 1 1 1 1 1 1 1 1 1 1 1 9 8 9 10 
0 39 38 37 36 1 1 1 1 1 1 27 26 1 1 1 1 1 1 1 1 1 1 1 1 1 1 1 1 1 1 1 
0 38 37 36 35 34 33 32 31 2 29 2 27 1 1 1 1 1 1 1 1 1 1 1 1 1 1 1 1 1 1 1 
0 39 38 37 36 35 34 33 32 31 30 29 28 1 1 1 1 1 1 1 1 1 1 1 1 1 1 1 1 1 1 1 
0 40 39 38 37 36 35 34 33 32 31 30 29 1 1 1 1 1 1 1 1 1 1 1 1 1 1 1 1 1 1 1 
0 41 40 1 1 1 1 1 1 33 32 31 30 1 1 1 1 1 1 1 1 1 1 1 1 1 1 1 1 1 1 1 
0 42 41 1 1 1 1 1 1 34 33 32 31 1 1 1 1 1 1 1 1 1 1 1 1 1 1 1 1 1 1 1 
0 43 42 1 1 1 1 1 1 35 34 33 32 33 34 35 36 37 38 1 1 1 1 1 1 1 1 1 1 1 1 1 
0 44 43 1 1 1 1 1 1 36 35 34 33 34 35 36 37 38 39 40 41 42 43 44 45 46 47 48 49 50 0 0 
0 45 44 1 1 1 1 1 1 37 36 35 1 1 1 1 1 1 1 1 1 1 44 45 46 47 48 49 50 0 0 0 
0 46 45 1 1 1 1 1 1 38 37 36 1 1 1 1 1 1 1 1 1 1 45 46 47 48 49 50 0 0 0 0 
0 47 46 1 1 1 1 1 1 39 38 37 1 1 1 1 1 1 1 1 1 1 46 47 48 49 50 0 0 0 0 0 
0 48 47 1 1 1 1 1 1 40 39 38 1 1 1 1 1 1 1 1 1 1 47 48 49 50 0 0 0 0 0 0 
0 49 48 47 2 45 44 43 42 2 40 39 1 1 1 1 1 1 1 1 1 1 48 49 50 0 0 0 0 0 0 0 
0 0 49 48 47 46 45 44 43 42 41 40 1 1 1 1 1 1 1 1 1 1 49 1 1 1 1 1 1 1 1 1 
0 0 0 49 48 47 46 45 44 43 42 41 1 1 1 1 1 1 1 1 1 0 50 1 1 1 1 1 1 1 1 1 
0 0 0 0 49 48 47 46 45 44 43 42 43 44 45 46 47 48 49 50 0 0 0 1 1 1 1 1 1 1 1 1 
0 0 0 0 2 49 48 47 46 45 44 43 44 45 46 47 48 49 50 0 0 0 0 1 1 1 1 1 1 1 1 1 
0 0 0 0 0 50 49 48 47 46 45 44 45 46 47 48 49 50 0 0 0 0 0 1 1 1 1 1 1 1 1 1 
0 0 0 0 0 0 50 49 48 47 46 45 46 47 48 49 50 0 0 0 0 0 0 1 1 1 1 1 1 1 1 1 
0 0 0 0 0 0 0 50 49 48 47 46 47 48 49 50 0 0 0 0 0 0 0 1 1 1 1 1 1 1 1 1 